111111
120001
101001
113101
100001
111111