111111111111111111111111111111
100000111000000010000010011111
101110111101101000111110111111
100010000001101310111100011111
121110111011101110111111111111
100000111011101100000111001111
110110000000001111110010011111
110110111111111300000000111111
110110111111111111111000111111
110000000000000011000000000111
110111101111111011011011110111
110111101111111011011011100011
110111100000000311000001101111
110000001111111000011100001111
111111111111111111111111111111